11111111111111111111111
10100010001000100010001
10101010101010101010101
10101010101010101010101
10101010101010101010101
10101010101010101010101
100010001000100010001P1
11111111111111111111111