111111111111111111111111
1000000000000001
11010010100001001111    
101000000011110001
1011000001 110001
10001000011110000111
101000001  1000P111111
1111111111 11111111111111
