111111111111111111111111
1000000000000001
11010010100001001111    
1010000000011 10001
10110000001 110001
10001000011110000111
101000001    1000P111111
111111111111111111111111
