1111111111111111111111
1000000010000000000011
1000000010010000000011
10011111100100000000011
101		10011110000000011
1001111111111000000E111
11111111    11111111111111
111 111111111111111111