1111111111111111111111
100000010000000000011
100000001001000000001
10011111100100000011
101     1001111000001
10011111111110000N111
11111111    1111111111
111 111111111111111111