111111111111111111111
100000001000000000001
100000001000000000001
100000000000000000001
100000001000000000001
1000000010000000000P1
111111111111111111111