NO luffy.xpm
SO luffy.xpm
WE luffy.xpm
EA luffy.xpm

F 125,125,125
C 170,10,200

1111111111111111111111
100000010000000000011
100000001111100000011
10011111100100000011
101     1001111001001
10011111111110000N111
11111111    1111111111
111 111111111111111111