SO textures/avatars-UidYWfW20bjki8Ub-GJKpBQ-t500x500-_1_.xpm
NO textures/2.xpm
F 10,10,200
WE textures/1.xpm



EA textures/wall.xpm

C 140,140,240

1111111111111111111111
101010010000000000011
1001N0000000000000001
101010001111100000011
10011111100100000011
101     1001111001001
100111111111100000111
11111111    1111111111
111 111111111111111111