SO textures/avatars-UidYWfW20bjki8Ub-GJKpBQ-t500x500-_1_.xpm
NO textures/Stoneflag.xpm
EA textures/wall.xpm
WE textures/StoneHitler.xpm


F 10,10,200

C 140,140,240w


                                  1
                                 101
                               110001
                              1000001    
                             10000001
                            100000001
11111111111111111111111111110000000001
10000000000000000000000000000000000111
10000000000000000000000000000000000011
10000000000000000000000000000000000011
100000000000000000000000000000000000011
1000000000000000000000000000000000E0001
111111111111111111111111111111111111111