SO textures/avatars-UidYWfW20bjki8Ub-GJKpBQ-t500x500-_1_.xpm
NO textures/Stoneflag.xpm
EA textures/wall.xpm
WE textures/StoneHitler.xpm


F 10,10,200


C 140,140,240

                              1111
        111111111111111111111110000001
        1E0000000000000000000000111111
        1011000000001111000000001
        100100000001    100000001
11111111101100000000111100000001
100000000011000001000000011111111
11110111111111011101111111111111111
11110111111111011101010010001
11000000110101011100000010001
10000000000000001100000010001
10000000000000001101010010001
110000011101010111110111100111
11110111 1110101 101111010001
11111111 1111111 111111111111
